equator_y_on_province_image = 2000

# No winter
tropical = {
	# Caribbean
    227 226 225 224 222 223 221 220 219 218 217 216 215 213 214
    
    # Florida
    592 593 594 595 596 923 926 927 928 1162 1163 1164 
}

# No winter
arid = {
    # California
	1 2 3 45 63 64 65 67 68 69 72 73 74 75 84 85 86 236 244 377 382 383 384 385 387 388 390 391 392 395 396 397 398 399 400 401 403 405 406 407 408 
    409 410 411 422 424 425 555 558 559 561 562 563 564 565 868 871 916 973 996 997 998 999 1000 1002 1003 1004 1005 1006 1008 1009 1010 1011 1012 
    1013 1014 1015 1016 1017 1018 1021 1022 1023 1024 1025 1026 1027 1028 1029 1030 1031 1032 1033 1034 1037 1038 1039 1040 1041 1042 1043 1046
    1047 1048 1049 1050 1051 1052 1053 1054 1055 1056 1058 1059 1060 1061 1071 1072 1073 1120 1122 1123 1124 1202 1203 1204 1205 1206 1207 1208 1215 
    1216 1221 1222 1224 1225 1226 1255 1279 1287 1302 1303 1304 1305 1306 1307 1308 1402 1403 1404 1405 1411 1413 1415 1416 1420 1421 1422 1423 1424 
    1959 1958 1930 1932 1931 1933 1934 1929 1927 1928 1923 1922 1921 1924 1925 1926 1940 1919 1918 1911 1941 1943 1942 1944 1936 1945 1935 1946
    1947 1948 1950 1951 1952 1949 1957 1956 1954 1953 1939
    
    # Nevada
    61 62 71 90 91 92 93 94 97 98 103 109 110 115 117 118 119 120 121 122 123 127 251 252 253 254 255 256 257 260 261 262 263 264 265 266 267 268 
    272 273 284 285 309 338 340 347 412 413 426 427 428 429 430 431 432 433 556 557 566 567 1019 1020 1044 1045 1057 1062 1063 1064 1065 1066 1067 
    1068 1069 1070 1074 1075 1076 1077 1078 1079 1080 1081 1082 1083 1084 1085 1086 1087 1088 1089 1090 1091 1092 1093 1094 1095 1096 1097 1098 1099 
    1100 1131 1200 1201 1209 1210 1211 1212 1213 1217 1218 1219 1220 1223 1227 1228 1281 1282 1349 1401 1407 1410 1426 1427 1428 1429 1430
    1920 1938 1937
    
    # Arizona
    879 1436 1449 1447 493 1435 87 130 352 491 497 498 125 124 128 1491 
    1133 354 88 496 1380 1378 1442 1379 1443 1441 1439 1440 1132 259 258
    1296 1377 1453 877 495 1438 1437 356 494 1444 1445 1446 1450 1451 
    492 1448 1452 126 415 129 1460 1461 1462 1463 353
    1913 1914 1912 1916 1917 1915 1955

    # Baja California
    78 79 80 81 82 83 166 167 866 1192 1910
    
    # Mexico
    21 22 23 24 28 30 32 192 193 195 196 197 198 199 200 201 202 203 204 
    205 206 207 208 209 210 211 212 322 499 500 501 502 503 504 505 506 
    510 511 512 513 514 515 517 518 519 520 521 522 523 525 526 528 529 
    530 531 532 533 534 535 536 537 980 981 984 985
    
    # Texas
    26 27 31 33 34 35 36 37 148 191 310 311 312 313 316 317 318 319 320 
    321 328 329 355 489 508 509 524 527 841 842 843 844 846 847 848 849 
    850 851 852 853 854 855 856 857 858 859 860 861 862 863 864 865 867 
    869 870 876 881 883 884 885 886 887 888 891 896 899 900 901 907 909 
    915 936 939 941 959 961 963 971 972 974 975 976 977 978 979 1135 
    1136 1195 1196
    
    # New Mexico
    334 335 350 351 1488 1486 1487 362 363 1455 1454 1456 361 358 507 
    882 359 360 357 1489 1490 364 1134 25 982 983 1458 1457 1459 1464 
    1467 1466 1465
}

arctic = {
    # British Columbia
    230 231 704 705 706 707 708 709 710 711 712 713 714 715 716 717 718 
    719 720 721 722 723
    
    # Saskatchewan
    612 677 678 679 680 681 682 683 684 685 686 687 688 689 690 691
    
    # Alberta
    611 692 693 694 695 696 697 698 699 700 701 702 703
    
    # Ontario
    178 179 189 190 298 629 630 631 632 633 634 635 636 637 638 639 640 
    641 642 643 644 645 646 910 987 988 989 1001 1007 1118 1190 1191 
    1197 1198 
    
    # New Brunswick
    169 174 176
    
    # Nova Scotia
    170 171 172 173 181
    
    # Quebec
    175 177 182 183 184 185 186 187 188 616 617 618 619 620 621 622 623 
    624 625 626 627 628 
    
    # Newfoundland and Labrador
    614 615
    
    # Manitoba
    613 647 655 650 649 651 653 657 648 656 654 652
}

mild_winter = {
	# Oregon
    247 278 279 872 1035 1036 1111 1125 1309 1310 1311 1312 1320 1328 1329 1330 1348 
    
    # Utah
    51 52 58 59 60 99 100 101 102 104 105 106 107 111 113 132 330 341 
    342 343 414 423 560 568 569 1214 1252 1254 1256 1286 1357 1358 1359 
    1364 1370 1371 1372 1373 1385 1386 1387 1388 1389 1390 1391 1392 
    1432 1406 1492 1493 
    
    # Colorado
    57 1485 333 336 1257 417 55 1496 875 878 1497 137 416 1251 138 56 1495 1431 348 133 134 1479 880 139 136 889 1384 1382 1381 135 435 434 349 1484 331 1477 1475 1478 337 54 1494 1468 1258 571 1469 1474 1473 1471 1470 1472 1498 570
    
    # Louisiana
    805 806 807 808 809 810 811 812 813 814 815 816 817 818 893 921 1117 
    1146
    
    # Arkansas
    323 819 820 821 822 823 824 825 826 827 894 895 897
    
    # Indiana
    66 95 96 112 114 116 149 232 234 235 238 246 269 270 942 943 1152 
    1153
    
    # North Carolina
    575 576 597 598 599 600 601 602 604 937 938 949 1172
    
    # South Carolina
    573 574 577 932 933 1170 1171
    
    # Missouri
    144 146 324 326 441 443 444 445 753 754 755 756 757 758 759 760 761 
    762 770 771 917 1244 1239 1243 1245 1247 1248 1383 1399
    
    # Kentucky
    332 339 344 345 346 365 366 367 368 369 370 940 1144 1155
    
    # Tennessee
    775 776 777 778 779 780 781 782 783 784 785 786 787 918 934 935 
    1156
    
    # Mississippi
    793 794 795 796 797 798 799 800 801 802 803 804 919 920 1158 
    1157 1159
    
    # Alabama
    586 587 589 590 591 788 789 790 791 792 922 924 925 1160 1161
    
    # Georgia
    578 579 580 581 582 583 584 585 588 929 930 931 1165 1166 1167 1168 
    1169
    
    # Oklahoma
    140 143 314 315 327 828 829 830 831 832 834 835 836 837 838 839 840 
    892 
    
    # Iowa
    145 449 450 453 454 902 1143 1400
    
    # Kansas
    141 142 147 164 165 325 437 440 446 772 773 774 890 1145 1199 
    1232 1246 1249 1393 1397 1398 
    
    # Ohio
    10 29 53 70 76 77 89 295 297 946 1154
    
    # West Virginia
    233 271 289 296 371 372 373 374 375 376 378 948 951 1173 1176 1180
}

normal_winter = {
    # Illinois
    150 151 152 153 154 155 442 479 480 481 482 483 484 486 763 764 765 766 767 768 769 905 1149 1233 1234 1235 1236 1237 1238 1240 1241 1242 1259 1394 
    1395 
    
    # Capital Wasteland
    4 5 13 14 15 16 17 18 19 20 38 39 40 41 42 43 44 46 47 48 49 50 156 157 158 159 162 194 248 280 302 303 304 953 1178 1179 1229 1230 1231 1260 1280 1285 
    1300 1408 1409 1412 1414 1417 1418 1419 
    
    # Commonwealth
    168 538 539 540 541 542 543 544 545 546 547 548 549 550 551 552 553 554 833 845 966 967 968 969 970 986 990 991 992 993 994 995 1114 1116 1184 1185 1186 1187 1188 1189 1261 1262 1263 1264 1265 1266 1267 1268 1269 1270 1271 1272 1273 1274 1275 1276 1277 1278 1288 1289 1290 1291 1292 1293 1294 1295 1297 1298 1299 1301
    
    # Virginia
    950 608 952 603 1174 606 607 609 605 610 160 1175 286 287 161 288 1177 1115
    
    # Pennsylvania
    281 282 283 290 291 292 293 294 300 301 305 306 307 308 379 380 381 386 389 393 394 402 404 439 451 516 947 954 955 956 957 1121 1181 1182 
    
    # New York
    163 732 733 734 735 736 737 738 739 740 741 742 743 744 745 746 747 748 749 750 751 752 958 960 964 965 1183 1194 1283
    
    # New Jersey
    299 726 727 728 729 730 731 962 1284
    
    # Nebraska
    436 438 447 448 452 456 457 490 898 1113 1141 1193
    
    # Wyoming
    418 421 455 458 463 464 465 1130 1139 1140 1250 1374 1375 1376
    
    # Idaho
    108 131 249 250 1119 1129 1253 1313 1335 1337 1338 1339 1340 1341 
    1342 1343 1344 1345 1346 1347 1350 1355 1356 1360 1361 1362 1363 
    1365 1366 1367 1368 1369 1429 1430 
    
    # Wisconsin
    478 487 488 912 913 914 1148 1396
    
    # Michigan
    180 485 911 944 945 1150 1151
    
    # Minnesota
    474 475 664 904 908 1142 1147
    
    # South Dakota
    419 420 470 471 472 473 665 903 1112 
    
    # Montana
    237 239 240 243 245 459 460 461 462 466 467 468 667 668 669 670 671 672 673 674 675 676 1137 1138 1351 1352 1353 1354
    
    # North Dakota
    241 242 469 476 477 658 659 660 661 662 663 666 906
    
    # Washington
    229 274 275 276 277 724 725 873 874 1126 1434 1128 1433 1314 1315 
    1316 1317 1318 1319 1321 1322 1323 1324 1325 1326 1331 1332 
    1333 1334 1336
}

severe_winter = {
    # British Columbia
    230 231 704 705 706 707 708 709 710 711 712 713 714 715 716 717 718 
    719 720 721 722 723
    
    # Saskatchewan
    612 677 678 679 680 681 682 683 684 685 686 687 688 689 690 691
    
    # Alberta
    611 692 693 694 695 696 697 698 699 700 701 702 703
    
    # Ontario
    178 179 189 190 298 629 630 631 632 633 634 635 636 637 638 639 640 
    641 642 643 644 645 646 910 987 988 989 1001 1007 1118 1190 1191 
    1197 1198 
    
    # New Brunswick
    169 174 176
    
    # Nova Scotia
    170 171 172 173 181
    
    # Quebec
    175 177 182 183 184 185 186 187 188 616 617 618 619 620 621 622 623 
    624 625 626 627 628 
    
    # Newfoundland and Labrador
    614 615
    
    # Manitoba
    613 647 655 650 649 651 653 657 648 656 654 652
}

impassable = {
	6 7 8 9 
}

mild_monsoon = {

}

normal_monsoon = {

}

severe_monsoon = {
    
}

