#----------------------------------
# Terrain Categories
#----------------------------------
categories =  {
    #----------------------------------
    # Core
    #----------------------------------
    pti = {
        type = pti
    }
    ocean = {
        movement_cost = 1.0
        is_water = yes
        sound_type = sea
        color = { 255 255 255 }
    }
    inland_ocean = {
        movement_cost = 1.0
        is_water = yes
        inland_sea = yes
        sound_type = sea
        color = { 0 0 200 }
    }
    
    #----------------------------------
    # Common
    #----------------------------------
    fm_settlement = {
        nation_designer_cost_multiplier = 1
        
        movement_cost = 1.0  
        
        supply_limit = 10
        allowed_num_of_buildings = 3
        
        sound_type = plains
        color = { 138 127 113 }
        
        terrain_override = {
            1 2 3 4 5 13 14 15 16 17 19 20 36 37 38 39 40 41 42 43 44 46 47 48 49 50 60 63 69 73 74 83 102 109 116 119 120 121 123 127 130 139 140 143 144 146 149 150 156 157 158 159 160 161 162 163 168 169 170 171 175 177 178 179 180 185 187 188 189 191 192 194 195 198 202 203 204 207 216 226 229 231 234 241 245 246 248 249 261 262 263 278 280 281 282 283 284 286 287 288 289 290 291 294 297 299 300 301 302 303 305 308 309 311 312 314 315 316 319 320 328 334 335 339 346 352 362 379 380 381 382 383 384 385 386 387 388 400 405 407 408 409 424 425 430 431 432 433 449 471 477 483 486 487 514 516 518 539 543 545 546 548 549 550 553 554 556 558 559 562 563 564 565 573 574 580 581 585 587 589 593 597 598 599 602 605 608 611 612 613 692 726 727 728 729 731 732 733 734 737 739 741 747 748 754 758 763 766 773 778 782 783 785 787 793 807 808 810 823 841 842 844 846 847 853 860 864 865 868 870 887 889 893 895 897 898 902 921 929 934 946 948 950 953 954 957 962 964 965 968 970 988 989 990 994 1002 1024 1049 1116 1120 1122 1123 1131 1142 1146 1151 1154 1155 1157 1158 1181 1187 1195 1196 1197 1200 1202 1203 1207 1212 1215 1219 1221 1223 1225 1226 1227 1228 1229 1230 1234 1239 1240 1242 1243 1244 1246 1251 1259 1260 1261 1264 1265 1268 1271 1273 1278 1279 1280 1281 1282 1283 1284 1286 1288 1299 1300 1302 1303 1304 1329 1347 1382 1383 1384 1393 1395 1398 1399 1407 1408 1409 1410 1411 1412 1414 1415 1416 1417 1418 1419 1426 1428 1917 1933 1950
        }
    }
    
    fm_swamp = {
        nation_designer_cost_multiplier = 0.85
        
        movement_cost = 1.3
        defence = 1
        combat_width = -0.25

        local_development_cost = 0.25
        supply_limit = 5

        type = marsh
        sound_type = forest
        color = { 34 135 106 }
        
        terrain_override = {
            540 541 542 544 594 595 596 805 806 926 927 928 1162 1163 1164 1165 1167 1185 1231 1263 1285 1301
        }
    }
    
    fm_desert = {
        nation_designer_cost_multiplier = 0.8
        
        movement_cost = 1.05
        
        supply_limit = 4
        local_development_cost = 0.35
        
        type = desert
        sound_type = desert
        color = { 219 211 55 }
        
        terrain_override = {
            21 22 24 26 28 30 31 45 78 85 86 87 88 90 91 92 93 94 97 117 118 122 166 193 209 210 211 212 251 252 254 255 256 259 265 272 273 340 347 355 356 358 361 410 413 422 426 427 428 429 491 495 496 497 499 500 501 502 505 506 507 508 509 510 511 512 513 517 519 520 521 522 523 525 526 527 536 561 877 882 985 1016 1017 1020 1043 1044 1045 1046 1057 1062 1063 1064 1065 1066 1067 1070 1074 1076 1077 1078 1079 1080 1081 1082 1083 1084 1085 1086 1087 1091 1092 1093 1094 1095 1097 1098 1192 1201 1210 1211 1218 1296 1305 1306 1307 1308 1377 1378 1380 1407 1423 1437 1438 1440 1441 1442 1443 1444 1445 1446 1449 1450 1451 1910 1911 1912 1913 1914 1915 1916 1918 1919 1920 1922 1928 1929 1930 1931 1934 1935 1936 1937 1938 1939 1940 1941 1942 1943 1944 1945 1946 1947 1948 1955 
        }
    }
    
    fm_wasteland = {
        nation_designer_cost_multiplier = 1
        
        movement_cost = 1.0
        
        supply_limit = 8
        allowed_num_of_buildings = 1
        
        type = plains
        sound_type = plains
        color = { 209 154 82 }
        
        terrain_override = {
            25 27 33 34 35 52 59 65 68 70 72 79 80 81 82 104 106 108 129 133 135 136 141 142 145 147 151 154 155 164 165 167 199 200 200 205 208 222 223 235 238 242 269 270 310 318 321 322 324 325 327 329 341 348 349 350 351 357 359 360 364 391 392 395 396 398 411 419 420 423 434 435 436 437 438 440 444 445 448 450 452 453 454 455 456 457 459 461 462 462 466 467 468 469 473 474 479 480 481 482 484 490 493 524 530 531 555 658 659 660 661 662 663 666 668 669 670 678 679 693 694 756 757 759 761 762 767 772 774 779 780 781 784 794 797 801 811 812 813 818 819 820 822 825 826 828 829 830 831 832 834 835 836 837 838 839 840 843 848 849 850 850 855 856 857 858 858 859 866 867 869 870 876 880 881 883 884 885 886 888 890 892 894 896 899 900 901 903 904 905 906 907 909 913 915 918 936 939 941 942 959 961 963 963 964 971 972 975 976 977 978 979 980 981 982 983 984 1003 1005 1006 1008 1009 1010 1013 1015 1021 1025 1027 1032 1051 1117 1134 1135 1136 1137 1141 1143 1149 1199 1206 1224 1233 1235 1237 1238 1241 1242 1245 1247 1248 1249 1252 1357 1358 1365 1367 1368 1371 1372 1381 1385 1386 1389 1391 1392 1397 1400 1413 1478 1488 1489 1490 1491
        }
    }
    
    fm_forest = {
        nation_designer_cost_multiplier = 0.9
        
        movement_cost = 1.25
        defence = 1
        combat_width = -0.20
        
        supply_limit = 3
        local_development_cost = 0.2
        
        type = forest
        sound_type = forest
        color = { 58 156 51 }   

        terrain_override = {
            10 18 29 53 66 66 76 77 89 95 96 100 101 112 114 119 152 153 172 174 176 181 184 186 190 232 237 250 275 276 279 292 295 296 298 304 306 307 313 323 326 332 344 345 361 365 366 367 368 369 373 375 378 389 393 393 394 399 401 402 404 439 441 442 443 446 447 451 470 475 476 478 485 488 538 551 552 575 579 582 584 586 588 590 591 600 601 603 604 606 614 615 617 618 619 620 620 621 622 623 624 625 627 628 629 630 631 632 633 634 635 636 637 638 639 640 641 642 643 644 645 646 647 648 649 650 651 652 653 654 655 656 657 664 667 671 673 677 680 681 682 683 684 685 686 687 688 689 690 691 695 697 698 699 702 730 734 735 736 738 740 745 749 752 755 760 764 765 768 769 770 771 777 786 788 789 790 791 792 795 796 799 800 802 803 804 814 816 821 824 827 852 854 863 871 872 873 891 908 910 911 912 914 917 919 920 922 923 924 925 930 932 933 937 940 944 945 952 955 956 958 960 966 967 969 970 986 987 991 992 993 995 1000 1011 1014 1018 1022 1026 1028 1029 1030 1031 1033 1036 1039 1048 1050 1054 1072 1113 1114 1115 1121 1124 1127 1140 1144 1145 1147 1149 1150 1152 1153 1160 1161 1166 1168 1170 1171 1174 1175 1178 1180 1182 1183 1184 1186 1188 1189 1190 1191 1193 1194 1204 1253 1262 1269 1270 1275 1276 1277 1297 1298 1312 1316 1319 1321 1323 1324 1328 1332 1333 1334 1336 1343 1350 1353 1354 1363 1366 1369 1373 1394 1396
        }
    }
    
    fm_hills = {
        nation_designer_cost_multiplier = 0.75
        
        movement_cost = 1.5
        defence = 2
        combat_width = -0.50
        
        local_defensiveness = 0.25
        local_development_cost = 0.5
        supply_limit = 4

        type = mountains
        sound_type = mountain
        color = { 82 62 16 }
        
        terrain_override = {
            23 51 54 55 56 57 61 62 64 67 71 72 75 98 99 103 105 107 110 111 113 115 124 125 126 128 131 134 137 138 148 196 197 201 206 233 236 239 240 243 244 247 253 257 258 260 264 266 267 271 274 274 277 285 330 331 333 336 337 338 342 343 353 354 363 372 374 376 390 397 403 412 414 415 416 417 418 421 458 463 465 492 498 503 504 529 532 533 534 535 537 557 560 566 567 568 569 570 571 576 577 578 607 609 610 665 672 674 675 676 696 700 703 704 705 706 707 710 711 712 713 714 715 716 717 718 719 720 721 722 723 724 725 744 775 861 862 874 875 878 931 935 949 951 996 998 999 1004 1012 1019 1023 1034 1035 1037 1038 1041 1042 1052 1053 1055 1056 1058 1059 1060 1061 1068 1069 1071 1073 1075 1088 1089 1090 1096 1099 1100 1111 1112 1125 1126 1128 1129 1130 1132 1133 1139 1156 1173 1176 1177 1205 1209 1213 1214 1216 1217 1220 1236 1250 1254 1255 1256 1257 1258 1287 1309 1310 1311 1313 1314 1315 1316 1318 1320 1322 1325 1326 1327 1330 1331 1335 1337 1338 1339 1340 1341 1342 1344 1345 1346 1348 1349 1351 1352 1355 1356 1359 1360 1361 1362 1364 1370 1374 1375 1376 1387 1388 1390 1401 1403 1404 1405 1406 1425 1427 1431 1432 1433 1434 1435 1436 1447 1448 1452 1453 1454 1455 1456 1457 1458 1459 1460 1461 1462 1463 1464 1465 1466 1467 1468 1469 1470 1471 1472 1473 1474 1475 1476 1477 1479 1480 1481 1482 1483 1484 1485 1486 1487 1492 1493 1494 1495 1496 1497 1498 1499 1921 1923 1924 1925 1926 1932 1958 1959
        }
    }
    
    fm_coastline = {
        nation_designer_cost_multiplier = 1
        
        movement_cost = 1.0
        
        supply_limit = 10
        allowed_num_of_buildings = 1
        
        sound_type = sea
        color = { 85 114 173 }
        
        terrain_override = {
            173 182 183 213 214 215 217 218 219 220 221 224 227 228 230 406 592 616 708 743 744 750 751 809 817 833 845 851 916 938 947 973 997 1001 1007 1118 1159 1169 1172 1179 1198 1266 1267 1274 1960 1961 1962 1963 1964 1965 1966 1967 1968 
        }
    }
    
    fm_irradiated_wasteland = {
        nation_designer_cost_multiplier = 1
        
        movement_cost = 1.5
        combat_width = -0.50
        
        supply_limit = 1
        local_development_cost = 1
        
        type = plains
        sound_type = plains
        color = { 29 112 62 }
        
        terrain_override = {
            84 377 547 1208 1272 1402 1420 1421 1421 1422 1424 1429 1430 1949 1951 1952 1953 1954 1956 1957
            887 1196 860
        }    
    }
}
    
#----------------------------------
# Terrain Association
#----------------------------------
terrain = {
    grasslands               = { type = fm_wasteland                   color = { 0 } }
    hills                    = { type = fm_hills                color = { 1 } }
    desert_mountain          = { type = fm_hills                color = { 2 } }
    desert                   = { type = fm_desert                   color = { 3 } }

    plains                   = { type = fm_wasteland                   color = { 4 } }
    terrain_5                = { type = fm_wasteland                   color = { 5 } }
    mountain                 = { type = fm_wasteland                   color = { 6 } }
    desert_mountain_low      = { type = fm_desert                   color = { 7 } }

    terrain_8               = { type = fm_hills                 color = { 8 } }
    marsh                   = { type = fm_swamp                     color = { 9 } } 
    terrain_10              = { type = fm_wasteland                    color = { 10 } }
    terrain_11              = { type = fm_wasteland                    color = { 11 } }

    forest_12               = { type = fm_forest                    color = { 12 } }
    forest_13               = { type = fm_forest                    color = { 13 } }
    forest_14               = { type = fm_forest                    color = { 14 } }
    ocean                   = { type = ocean                        color = { 15 } }

    snow                    = { type = fm_hills                   color = { 16 } }
    inland_ocean_17         = { type = inland_ocean                 color = { 17 } }

    coastal_desert_18       = { type = fm_desert                    color = { 19 } }
    coastline               = { type = fm_coastline                    color = { 35 } }
    
    savannah                = { type = fm_wasteland                    color = { 20 } }
    drylands                = { type = fm_wasteland                    color = { 22 } }
    highlands               = { type = fm_hills                 color = { 23 } }
    dry_highlands           = { type = fm_hills                 color = { 24 } }
    
    woods                   = { type = fm_forest                    color = { 255 } }
    terrain_21              = { type = fm_wasteland                    color = { 21 } }    
}

#----------------------------------
# Tree Association
#----------------------------------
tree = {
    forest  = { terrain = fm_forest         color = { 3 4 6 7 19 20 } }
    woods   = { terrain = fm_forest         color = { 2 5 8 18      } }
    jungle  = { terrain = ocean             color = { 13 14 15      } }
    palms   = { terrain = fm_desert         color = { 12            } }
    savana  = { terrain = fm_wasteland         color = { 27 28 29 30   } }
}

